10129
111111112211111
111111122111111
111122221111111
111111111111111
111221122111111
111111112211111
111111122111111
111122221111111
111111111111111
111221122111111
